111111111111111111
100100000000001001
1000000P0000010001
100000000000000001
100000000000000001
10C00C000000000001
100001000C000C0001
10001101000X0001E1
111111111111111111
