11111111111111111111111111111111111111111111111111111111111111
1C0000C100C000X0000C000X000C0000000000000C000C10000000000000E1
100X000101111111111111111111100X000000000100001C000000000X0011
11111001011000000000000000001111111100000000001000000011111111
1C00X000C10000000000111C0000P000000010000X0000100X000000000001
11111111110000000000001111000000000000011111011111111000000001
100C000C01000000000X000000110110001000C1C0C1C110000C0000000001
1C00000001C000000011100011100010010100C1C0C1C100C00000X00000C1
11000000C11000C011100000000C0C00100010C1C0C1000011111111111111
1000000011000010000000000111111000000C1000111111C00000000000C1
10000X00X00000000000000001000X0000C00CC1000000C1C0000000000X01
11111111111001100C000C001000111100X0001C00X00001C00000C1001111
1C00000000001CC10000X0000001100011111101111110001C0X0C1C000001
100X00000001000111111111111C00C0000C0000000000X001111111100001
1111111000100000000000X000C100X0001100000000C11100X00000000001
1CCCCCC000000000000011111000111111001111000C1111111111100000C1
1000X000X000X000X00000X0000C000X0000C00X00C111C00X0000X00000C1
11111111111111111111111111111111111111111111111111111111111111
